#    $Id: dict-de.in 1126 2012-12-04 04:52:46Z faxguy $

	CHARSET=iso-8859-1;
	DICTRECEIVEAGENT="HylaFAX Empfang";
	DICTRECEIVEDFROM="Fax empfangen von \$SENDER";
	DICTRETRIEVEDFROM="Fax geholt von \$SENDER";
	DICTMSGINTRO="Das ganze Dokument wurde nicht empfangen weil:";
	DICTLOGFOLLOWS="    ---- Ablauf der Uebertragung ----";
	DICTLOGFOLLOWS2="Ablauf der Uebertragung";
	DICTNOLOGAVAIL="    Kein Protokoll des Ablaufs verfügbar";
	DICTDISPATCHEDTO="Das Fax wurde automatisch weitergeleitet an: \$SENDTO.";
	DICTPOLLDISPATCHTO="Das Fax wurde abgerufen und zugestellt an: \$MAILADDR.";
	DICTNOTRECEIVED="Fax nicht empfangen";
	DICTATTEMPTEDFAXFAILED="Ein Versuch, ein Fax an \$DEVICE zu empfangen, schlug fehl da:";
	DICTATTEMPTEDPOLLFAILED="Ein Versuch, ein Fax an \$DEVICE zu holen, schlug fehl da:";
	DICTFAILEDBECAUSE="schlug fehl da:";
	DICTUNKNOWNDOCTYPE="Unbekannter Dokumententyp";
	DICTNOFILEEXISTS="Datei existiert nicht";
	DICTDESTINATION="Ziel";
	DICTJOBID="JobID";
	DICTGROUPID="GruppenID";
	DICTSENDER="Sender";
	DICTMAILADDR="Mailaddresse";
	DICTMODEM="Modem";
	DICTCOMMID="KommunikationsID";
	DICTSUBMITTEDFROM="Geschickt von";
	DICTPAGEWIDTH="Seiten Breite";
	DICTPAGELENGTH="Seiten Länge";
	DICTRES="Auflösung";
	DICTNOTHINGAVAIL="nichts verfügbar";
	DICTSTATUS="Status";
	DICTREMOTEEXCHANGES="Kommunikationsversuchen mit Zielfaxgerät";
	DICTDIALOGS="Dialoge";
	DICTFAILEDCALLS="nachfolgende fehlgeschlagene Anrufe zum Empfänger";
	DICTDIALS="Wählversuche";
	DICTTOTALCALLS="Anrufe insgesamt durchgeführt";
	DICTCALLS="Anrufe";
	DICTPAGESTRANSMITTED="Seiten übermittelt";
	DICTPAGES="Seiten";
	DICTTOTALPAGES="Seiten insgesamt zu übermitteln";
	DICTTOTPAGES="TotPages";
	DICTATTEMPTSPAGE="Versuche die derzeitige Seite zu senden";
	DICTATTEMPTS="Versuche";
	DICTDIRNEXTPAGE="Verzeichniss der nächsten zu übermittelnden Seite";
	DICTDIRNUM="Dirnum";
	DICTDOCSSUBMITTED="Dokumente zum Versand übermittelt";
	DICTDOCSTEXT1="Die folgenden Dokumente wurden zum Versand übermittelt und sind auf dem Server";
	DICTDOCSTEXT2="zur erneuten Nutzung verfügbar bis sie automatisch bereinigt werden, wenn";
	DICTDOCSTEXT3="dieser Auftrag `if [ \"\$doneop\" = archive ]; then echo 'archiviert'; else echo 'entfernt'; fi` wird. Dokumente können auch manuell entfernt werden";
	DICTDOCSTEXT4="durch Nutzung des faxrm Kommandos. Siehe dazu \'man faxrm\' für mehr Information.";
	DICTFILENAME="Dateiname";
	DICTSIZE="Größe";
	DICTTYPE="Typ";
	DICTUNSENTPAGES="Nicht gesendete Seiten zum Versand übermittelt";
        DICTUNSENTJOBSTATUS="Nicht gesendete Jobstatus";
	DICTPIN="PIN ";
	DICTMESSAGETEXT="Nachrichtentext";
	DICTNOREASON="kein Grund aufgezeichnet";
	DICTYOURJOBTO="Ihr \$THISJOBTYPE Auftrag an \$number";
	DICTfacsimile="Fax";
	DICTpager="Pager";
	DICTJOB="\$THISJOBTYPE Auftrag \$jobid";
	DICTAT="um";
	DICTTO="an";
	DICTCOMPLETED="abgeschlossen";
	DICTCOMPLETEDSUCCESSFULLY=" wurde erfolgreich abgeschlossen.";
	DICTRECEIVER="Empfänger";
	DICTQUALITY="Qualität";
	DICTFINE="Fine";
	DICTNORMAL="Normal";
	DICTSIGNALRATE="Übertragungsgeschwindigkeit";
	DICTDATAFORMAT="Datenformat";
	DICTREMOTEEQUIPMENT="Gegenstellen Equipment";
	DICTREMOTESTATION="Gegenstellen Station";
	DICTPROCESSINGTIME="Verarbeitungszeit";
	DICTADDITIONALINFO="  Zusätzliche Information:";
	DICTFAILED="fehlgeschlagen";
	DICTREJECTEDBECAUSE="wurde verworfen weil:";
	DICTBLOCKED="blockiert";
	DICTDELAYEDBECAUSE="ist in der Verarbeitungswarteschlange verzögert, weil:";
	DICTASSOONASPOSSIBLE="Der Auftrag wird so schnell wie möglich bearbeitet.";
	DICTREQUEUED="wiedereingefügt";
	DICTWASNOTSENT="wurde nicht gesendet, weil:";
	DICTWILLBERETRIED="Der Auftrag wird erneut bearbeitet um";
	DICTREMOVEDFROMQUEUE="aus der Verarbeitungswarteschlange entfernt";
	DICTWASDELETED="wurde aus der Verarbeitungswarteschlange gelöscht.";
	DICTTIMEDOUT="konnte nicht innerhalb der für den Auftrag verfügbaren Zeit vollendet werden.";
	DICTCONVERSION1="wurde nicht gesendet, weil die Dokumentenkonvertierung";
	DICTCONVERSION2="zum Fax fehlgeschlagen ist.  Die Ausgabe des Konvertierungsprogrammes war:";
	DICTCONVERSION3="Überprüfen Sie jedes PostScript Dokument auf nicht standard-konforme Fonts und invalide Konstruktionen";
	DICTNOFORMATTER1="wurde nicht gesendet, weil";
	DICTNOFORMATTER2="das Skript zur Dokumentenkonvertierung nicht gefunden wurde.";
	DICTNOTICEABOUT="Hinweis über";
	DICTPOLLINGFAILED=", ein Faxabruf,\nkonnte nicht vollendet werden, weil ";
	DICTREMOTEREJECTED="die Gegenstelle den Faxabruf abgewiesen hat.";
	DICTNODOCTOPOLL="kein Dokument zum Empfang verfügbar war.";
	DICTUNSPECIFIEDPROBLEM="ein nicht spezifiziertes Problem aufgetreten ist.";
	DICTUNKNOWNREASON1="irgendwas geschehen ist.";
	DICTUNKNOWNREASON2="Leider wurde das Benachrichtigungsskript aus unbekanntem Grund aufgerufen";
	DICTUNKNOWNREASON3="so dass der Rest dieser Nachricht dem Debugging dienen kann:";
	DICTUNKNOWNREASON4="Dies sollte nicht geschehen, bitte wenden Sie Sich an den Administrator.";
	DICTRECEIVEDON="EmpfangenAn";
	DICTPOLLFAILED="Faxabruf schlug fehl";
	DICTYES="Ja";
	DICTNO="Nein";
	DICTRECEIVED="Empfangen";
	DICTTIMETORECV="Verarbeitungszeit";
	DICTERRCORRECT="FehlerKorrektur";
	DICTCALLID1="Anrufe ID 1";
	DICTCALLID2="Anrufe ID 2";
	DICTCALLID3="Anrufe ID 3";
	DICTCALLID4="Anrufe ID 4";
	DICTCALLID5="Anrufe ID 5";
	DICTCALLID6="Anrufe ID 6";
	DICTCALLID7="Anrufe ID 7";
