#    $Id: dict-pl.in 1126 2012-12-04 04:52:46Z faxguy $

	CHARSET=iso-8859-2;
	DICTRECEIVEAGENT="Serwer faxów HylaFAX";
	DICTRECEIVEDFROM="Odebrano fax od \$SENDER";
	DICTRETRIEVEDFROM="Pobrano fax od \$SENDER";
	DICTMSGINTRO="Nie odebrano ca³o¶ci dokumentu, poniewa¿:";
	DICTLOGFOLLOWS="    ---- Transkrypcja sesji ----";
	DICTLOGFOLLOWS2="Transkrypcja sesji";
	DICTNOLOGAVAIL="    Nie odnaleziono transkrypcji sesji";
	DICTDISPATCHEDTO="Fax zosta³ automatycznie przes³any do: \$SENDTO.";
	DICTPOLLDISPATCHTO="Fax zosta³ dostarczony do: \$MAILADDR.";
	DICTNOTRECEIVED="Nie odebrano faxu";
	DICTATTEMPTEDFAXFAILED="Próba odebrania faksu na modemie \$DEVICE zakoñczy³a siê niepowodzeniem z powodu:";
	DICTATTEMPTEDPOLLFAILED="Próba pobrania faksu na modemie \$DEVICE zakoñczy³a siê niepowodzeniem z powodu:";
	DICTFAILEDBECAUSE="Przyczyna niepowodzenia:";
	DICTUNKNOWNDOCTYPE="Nieznany typ dokumentu";
	DICTNOFILEEXISTS="Plik nie istnieje";
	DICTDESTINATION="Adresat";
	DICTJOBID="ID zadania";
	DICTGROUPID="ID grupy";
	DICTSENDER="Nadawca";
	DICTMAILADDR="Adres e-mail";
	DICTMODEM="Modem";
	DICTCOMMID="ID Komunikacji";
	DICTSUBMITTEDFROM="Nadano przez";
	DICTPAGEWIDTH="Szeroko¶æ strony";
	DICTPAGELENGTH="Wysoko¶æ strony";
	DICTRES="Rozdzielczo¶æ";
	DICTNOTHINGAVAIL="niedostêpne";
	DICTSTATUS="Status";
	DICTREMOTEEXCHANGES="wymiany ze zdalnym urz±dzeniem";
	DICTDIALOGS="Po³±czeñ";
	DICTFAILEDCALLS="Kolejnych nieudanych prób po³±czenia telefonicznego";
	DICTDIALS="";
	DICTTOTALCALLS="£±cznie po³±czeñ telefonicznych";
	DICTCALLS="Po³±czeñ telefonicznych";
	DICTPAGESTRANSMITTED="stron przes³ano";
	DICTPAGES="Stron";
	DICTTOTALPAGES="³±cznie stron do przes³ania";
	DICTTOTPAGES="Stron";
	DICTATTEMPTSPAGE="prób wys³ania obecnej strony";
	DICTATTEMPTS="Prób";
	DICTDIRNEXTPAGE="katalog nastêpnej strony do wys³ania";
	DICTDIRNEXTPAGE="directory of next page to send";
	DICTDIRNUM="Katalog";
	DICTDOCSSUBMITTED="Dokumenty przeznaczone do transmisji";
	DICTDOCSTEXT1="Nastêpuj±ce dokumenty zosta³y przeznaczone do trasmisji i s±";
	DICTDOCSTEXT2="dostêpne na serwerze do ponownego u¿ycia do momentu, gdy zostan± automatycznie";
	DICTDOCSTEXT3="wyczyszczone, gdy zadanie zostanie `if [ \"\$doneop\" = archive ]; then echo 'zarchiwizowane' else echo 'usuniête'; fi`. Dokumenty mo¿na równie¿ usuwaæ";
	DICTDOCSTEXT4="rêcznie przy pomocy komendy faxrm. Proszê zajrzeæ do strony podrêcznika faxrm\(1\).";
	DICTFILENAME="Nazwa pliku";
	DICTSIZE="Rozmiar";
	DICTTYPE="Typ";
	DICTUNSENTPAGES="Niewys³ane stront przeznaczone do transmisji";
        DICTUNSENTJOBSTATUS="Unsent job status";
	DICTPIN="PIN ";
	DICTMESSAGETEXT="Tre¶æ wiadomo¶ci";
	DICTNOREASON="nie zarejestrowano powodu";
	DICTYOURJOBTO="Zadanie \$THISJOBTYPE do \$number";
	DICTfacsimile="fax";
	DICTpager="czysty tekst";
	DICTJOB="\$THISJOBTYPE zadanie \$jobid";
	DICTAT="o";
	DICTTO="do";
	DICTCOMPLETED="zakoñczone";
	DICTCOMPLETEDSUCCESSFULLY=" zakoñczone powodzeniem.";
	DICTRECEIVER="Odbiorca";
	DICTQUALITY="Jako¶æ";
	DICTFINE="Wysoka";
	DICTNORMAL="Zwyk³a";
	DICTSIGNALRATE="Sygna³";
	DICTDATAFORMAT="Format danych";
	DICTREMOTEEQUIPMENT="Zdalne urz±dzenie";
	DICTREMOTESTATION="Zdalna maszyna";
	DICTPROCESSINGTIME="Czas przetwarzania";
	DICTADDITIONALINFO="  Dodatkowe informacje:";
	DICTFAILED="nieudane";
	DICTREJECTEDBECAUSE="zosta³o odrzucone, poniewa¿:";
	DICTBLOCKED="zablokowane";
	DICTDELAYEDBECAUSE="zosta³o zatrzymane w kolejce wysy³ania, poniewa¿:";
	DICTASSOONASPOSSIBLE="Zadanie zostanie wykonane tak szybko, jak to jest mo¿liwe.";
	DICTWASNOTSENT="nie zosta³o wys³ane, poniewa¿:";
	DICTWILLBERETRIED="Nastêpna próba o";
	DICTREMOVEDFROMQUEUE="usuniêty z kolejki";
	DICTWASDELETED="zosta³o usuniête z kolejki";
	DICTTIMEDOUT="nie zosta³o zakoñczone przed terminem.";
	DICTCONVERSION1="nie zosta³o wys³ane, poniewa¿ konwersja dokumentu";
	DICTCONVERSION2="na fax zakoñczy³a siê niepowodzeniem. Komunikaty programu konwertuj±cego:";
	DICTCONVERSION3="Nale¿y sprawdziæ, czy w dokumentach PostScriptowych nie wystêpuj± niestandardowe czcionki lub nieprawid³owe konstrunkcje";
	DICTNOFORMATTER1="nie zosta³o wys³ane, powniewa¿";
	DICTNOFORMATTER2="skrypt konwertuj±cy dokumenty nie zosta³ odnaleziony.";
	DICTNOTICEABOUT="Powiadomienie o";
	DICTPOLLINGFAILED=" próba pobrania\n nie powiod³a siê, poniewa¿ ";
	DICTREMOTEREJECTED="zdalny fax odrzuci³ ¿±danie.";
	DICTNODOCTOPOLL="nie odnaleziono dokumentu do pobrania.";
	DICTUNSPECIFIEDPROBLEM="nast±pi³ nieoczekiwany problem.";
	DICTUNKNOWNREASON1="uleg³o uszkodzeniu.";
	DICTUNKNOWNREASON2="Niestety skrypt powiadamiaj±cy zosta³ uruchomiony z niewiadomego powodu, "
	DICTUNKNOWNREASON3="wiêc reszta tej wiadomo¶ci s³u¿y tylko celom diagnostycznym.";
	DICTUNKNOWNREASON4="To nie powinno mieæ miejsca. Proszê skontaktowaæ siê z administratorem.";
	DICTRECEIVEDON="Otrzymano";
	DICTPOLLFAILED="Pobranie faxu zakoñczy³o siê niepowodzeniem";
	DICTYES="Tak";
	DICTNO="Nie";
	DICTRECEIVED="Otrzymano";
	DICTTIMETORECV="D³ugo¶æ transmisji";
	DICTERRCORRECT="Korekcja b³êdów";
	DICTCALLID1="Po³±czenie ID1";
	DICTCALLID2="Po³±czenie ID2";
	DICTCALLID3="Po³±czenie ID3";
	DICTCALLID4="Po³±czenie ID4";
	DICTCALLID5="Po³±czenie ID5";
	DICTCALLID6="Po³±czenie ID6";
	DICTCALLID7="Po³±czenie ID7";
