#    $Id: dict-it.in 1126 2012-12-04 04:52:46Z faxguy $

	CHARSET=iso-8859-1;
	DICTRECEIVEAGENT="Server fax HylaFAX";
	DICTRECEIVEDFROM="Fax ricevuto da \$SENDER";
	DICTRETRIEVEDFROM="Fax scaricato da \$SENDER";
	DICTMSGINTRO="Il documento non è stato completamente ricevuto perché:";
	DICTLOGFOLLOWS="    ---- Segue trascrizione della sessione ----";
	DICTLOGFOLLOWS2="Segue trascrizione della sessione";
	DICTNOLOGAVAIL="    Trascrizione non disponibile";
	DICTDISPATCHEDTO="Il fax è stato automaticamente inviato a: \$SENDTO.";
	DICTPOLLDISPATCHTO="Il fax è stato richiesto da e inviato a: \$MAILADDR.";
	DICTNOTRECEIVED="fax non ricevuto";
	DICTATTEMPTEDFAXFAILED="Un tentativo di ricevere un fax su \$DEVICE è fallito perché:";
	DICTATTEMPTEDPOLLFAILED="Un tentativo di scaricare un fax tramite \$DEVICE è fallito perché:";
	DICTFAILEDBECAUSE="è fallito perché:";
	DICTUNKNOWNDOCTYPE="Tipo documento non riconosciuto";
	DICTNOFILEEXISTS="File inesistente";
	DICTDESTINATION="Destinatario";
	DICTJOBID="JobID";
	DICTGROUPID="GroupID";
	DICTSENDER="Mittente";
	DICTMAILADDR="E-mail";
	DICTMODEM="Modem";
	DICTCOMMID="CommID";
	DICTSUBMITTEDFROM="Inviato da";
	DICTPAGEWIDTH="Larghezza pagina";
	DICTPAGELENGTH="Altezza pagina";
	DICTRES="Risoluzione";
	DICTNOTHINGAVAIL="non disponibile";
	DICTSTATUS="Stato";
	DICTREMOTEEXCHANGES="connessioni stabilite con il dispositivo remoto";
	DICTDIALOGS="Dialoghi";
	DICTFAILEDCALLS="chiamate fallite consecutivamente al destinatario";
	DICTDIALS="Chiamate fallite";
	DICTTOTALCALLS="totale chiamate telefoniche effettuate";
	DICTCALLS="Chiamate";
	DICTPAGESTRANSMITTED="pagine trasmesse";
	DICTPAGES="Pagine";
	DICTTOTALPAGES="totale pagine da trasmettere";
	DICTTOTPAGES="Pagine tot.";
	DICTATTEMPTSPAGE="tentativi di inviare la pagina corrente";
	DICTATTEMPTS="Tentativi";
	DICTDIRNEXTPAGE="directory della prossima pagina da spedire";
	DICTDIRNUM="Dirnum";
	DICTDOCSSUBMITTED="Documenti accodati per l\'invio";
	DICTDOCSTEXT1="I seguenti documenti erano stati accodati per l\'invio e sono";
	DICTDOCSTEXT2="disponibili sul server per essere riutilizzati finché non saranno automaticamente";
	DICTDOCSTEXT3="eliminati quando questo lavoro sarà `if [ \"\$doneop\" = archive ]; then echo 'archiviato'; else echo 'rimosso'; fi`. I documenti possono anche essere manualmente";
	DICTDOCSTEXT4="eliminati con il comando faxrm\; consultare faxrm\(1\) per maggiori informazioni.";
	DICTFILENAME="Nome file";
	DICTSIZE="Dimensione";
	DICTTYPE="Tipo";
	DICTUNSENTPAGES="Pagine da trasmettere non inviate";
        DICTUNSENTJOBSTATUS="Condizione di lavoro non inviate";
	DICTPIN="PIN ";
	DICTMESSAGETEXT="Testo messaggio";
	DICTNOREASON="nessun motivo registrato";
	DICTYOURJOBTO="Il \$THISJOBTYPE per \$number";
	DICTfacsimile="fax";
	DICTpager="pager";
	DICTJOB="\$THISJOBTYPE \$jobid";
	DICTAT="alle";
	DICTTO="per";
	DICTCOMPLETED="completato";
	DICTCOMPLETEDSUCCESSFULLY=" è stato completato con successo.";
	DICTRECEIVER="Ricevente";
	DICTQUALITY="Qualità";
	DICTFINE="Fine";
	DICTNORMAL="Normale";
	DICTSIGNALRATE="Velocità di trasmissione";
	DICTDATAFORMAT="Formato dati";
	DICTREMOTEEQUIPMENT="Dispositivo remoto";
	DICTREMOTESTATION="Stazione remota";
	DICTPROCESSINGTIME="Il tempo di elaborazione è stato";
	DICTADDITIONALINFO="  Informazioni addizionali:";
	DICTFAILED="fallito";
	DICTREJECTEDBECAUSE="è stato rifiutato perché:";
	DICTBLOCKED="bloccato";
	DICTDELAYEDBECAUSE="è stato riaccodato nella coda dei lavori in attesa perché:";
	DICTASSOONASPOSSIBLE="Il lavoro verrà elaborato appena possibile.";
	DICTREQUEUED="riaccodato";
	DICTWASNOTSENT="non è stato spedito per il seguente motivo:";
	DICTWILLBERETRIED="Il lavoro verrà riprovato alle";
	DICTREMOVEDFROMQUEUE="rimosso dalla coda";
	DICTWASDELETED="è stato cancellato dalla coda.";
	DICTTIMEDOUT="non è stato completato prima dell'orario prefissato.";
	DICTCONVERSION1="non è stato inviato perché la conversione del documento";
	DICTCONVERSION2="in fax è fallita.  L'output del convertitore è stato:";
	DICTCONVERSION3="Verificare i documenti Postscript per l'uso di font non standard e construtti non validi";
	DICTNOFORMATTER1="non è stato inviato perché";
	DICTNOFORMATTER2="lo script di conversione del documento non è stato trovato.";
	DICTNOTICEABOUT="Avviso a riguardo di";
	DICTPOLLINGFAILED=", una richiesta di scaricamento fax,\nnon può essere completata perché ";
	DICTREMOTEREJECTED="il dispositivo remoto ha rifiutato la richiesta.";
	DICTNODOCTOPOLL="nessun documento era disponibile per essere scaricato.";
	DICTUNSPECIFIEDPROBLEM="si è verificato un problema non identificato.";
	DICTUNKNOWNREASON1="gli è capitato qualcosa.";
	DICTUNKNOWNREASON2="Sfortunatamente, lo script di notifica è stato richiamato per un motivo sconosciuto";
	DICTUNKNOWNREASON3="la parta restante di questo messaggio è solo per la ricerca dell'origine dell'errore:";
	DICTUNKNOWNREASON4="Questa situazione non si dovrebbe mai verificare, contattare l'amministratore del sistema.";
	DICTRECEIVEDON="Ricevuto tramite";
	DICTPOLLFAILED="scaricamento fax fallito";
	DICTYES="Sì";
	DICTNO="No";
	DICTRECEIVED="Ricevuto";
	DICTTIMETORECV="Durata della ricezione";
	DICTERRCORRECT="Correzione d'errore";
	DICTCALLID1="CallID1";
	DICTCALLID2="CallID2";
	DICTCALLID3="CallID3";
	DICTCALLID4="CallID4";
	DICTCALLID5="CallID5";
	DICTCALLID6="CallID6";
	DICTCALLID7="CallID7";
