#    $Id: dict-zh.in 1126 2012-12-04 04:52:46Z faxguy $

	CHARSET=UTF-8;
	DICTRECEIVEAGENT="传真接收程序";
	DICTRECEIVEDFROM="从 \$SENDER 收到传真";
	DICTRETRIEVEDFROM="传真来自 \$SENDER";
	DICTMSGINTRO="文件接收不全,因为:";
	DICTLOGFOLLOWS="    ---- 会话副本如下 ----";
	DICTLOGFOLLOWS2="会话副本如下";
	DICTNOLOGAVAIL="    没有有效的记录\(可供参考\)";
	DICTDISPATCHEDTO="传真被自动发送到: \$SENDTO.";
	DICTPOLLDISPATCHTO="传真被轮询并发送到: \$MAILADDR.";
	DICTNOTRECEIVED="传真未接收";
	DICTATTEMPTEDFAXFAILED="\(尝试\)在 \$DEVICE 上接收传真失败,因为:"
	DICTATTEMPTEDPOLLFAILED="\(尝试\)在 \$DEVICE 上检索传真失败，因为:";
	DICTFAILEDBECAUSE="失败原因:";
	DICTUNKNOWNDOCTYPE="未知的文件类型";
	DICTNOFILEEXISTS="文件不存在";
	DICTDESTINATION="目标文件";
	DICTJOBID="任务ID";
	DICTGROUPID="组ID";
	DICTSENDER="发件人";
	DICTMAILADDR="邮件地址";
	DICTMODEM="调制解调器";
	DICTCOMMID="命令ID";
	DICTSUBMITTEDFROM="被提交,从";
	DICTPAGEWIDTH="页宽";
	DICTPAGELENGTH="页长";
	DICTRES="分辨率";
	DICTNOTHINGAVAIL="没有可用\(有效\)的";
	DICTSTATUS="状态";
	DICTREMOTEEXCHANGES="与远程设备交换信息";
	DICTDIALOGS="对话";
	DICTFAILEDCALLS="对目标文件的调用连续失败";
	DICTDIALS="拨号";
	DICTTOTALCALLS="total phone calls placed";
	DICTCALLS="调用（呼叫）";
	DICTPAGESTRANSMITTED="传输（完的）页数";
	DICTPAGES="页";
	DICTTOTALPAGES="传输的总页数";
	DICTTOTPAGES="总页数";
	DICTATTEMPTSPAGE="\(尝试\)发送当前页";
	DICTATTEMPTS="尝试";
	DICTDIRNEXTPAGE="下一个发送页的目录";
	DICTDIRNUM="目录号";
	DICTDOCSSUBMITTED="提交文档（用于传输）";
	DICTDOCSTEXT1="下列文件是为传输所提交的,并且是";
	DICTDOCSTEXT2="在服务器上再使用是有效的,直到它们自动的";
	DICTDOCSTEXT3="删除任务,当它是 `if [ \"\$doneop\" = archive ]; then echo 'archived'; else echo 'removed'; fi`. 文件可能需要手工\(来删除\)";
	DICTDOCSTEXT4="被faxrm命令删除\; 查阅 faxrm\(1\) 相关信息.";
	DICTFILENAME="文件名";
	DICTSIZE="大小";
	DICTTYPE="类型";
	DICTUNSENTPAGES="\(传输而提交的\)页面未发送";
        DICTUNSENTJOBSTATUS="任务状态未发送";
	DICTPIN="PIN ";
	DICTMESSAGETEXT="消息正文";
	DICTNOREASON="无相关原因记录";
	DICTYOURJOBTO="你到 \$number 的 \$THISJOBTYPE任务";
	DICTfacsimile="传真";
	DICTpager="页调度程序";
	DICTJOB="\$THISJOBTYPE 任务 \$jobid";
	DICTAT="在";
	DICTTO="向";
	DICTCOMPLETED="完成";
	DICTCOMPLETEDSUCCESSFULLY=" 被成功的完成.";
	DICTRECEIVER="收件人";
	DICTQUALITY="分辨率（垂直）";
	DICTFINE="好的（98 lines\/inch）";
	DICTNORMAL="正常的（196 lines\/inch）";
	DICTSIGNALRATE="信号率";
	DICTDATAFORMAT="数据格式";
	DICTREMOTEEQUIPMENT="远程设备";
	DICTREMOTESTATION="远程站点";
	DICTPROCESSINGTIME="处理时间是";
	DICTADDITIONALINFO="  其他信息:";
	DICTFAILED="失败（的）";
	DICTREJECTEDBECAUSE="被拒绝的原因是:";
	DICTBLOCKED="块\/数据块";
	DICTDELAYEDBECAUSE="在调度队列中被延迟，因为:";
	DICTASSOONASPOSSIBLE="任务将会被尽快处理.";
	DICTREQUEUED="requeued";
	DICTWASNOTSENT="未发送,因为:";
	DICTWILLBERETRIED="任务将被重试，在";
	DICTREMOVEDFROMQUEUE="从队列中移除";
	DICTWASDELETED="被从队列中删除.";
	DICTTIMEDOUT="在最大发送时间内没有发送成功.";
	DICTCONVERSION1="未发送，因为文档转换";
	DICTCONVERSION2="传真失败.  输出转换程序为:";
	DICTCONVERSION3="为无效标记与非标准字体检查PostScript文件";
	DICTNOFORMATTER1="未发送,因为";
	DICTNOFORMATTER2="未发现用于文档转换的脚本.";
	DICTNOTICEABOUT="注视事项";
	DICTPOLLINGFAILED=", 轮询请求,\n未能完成,因为 ";
	DICTREMOTEREJECTED="对方拒绝你的请求.";
	DICTNODOCTOPOLL="没有有效的文件可供检索.";
	DICTUNSPECIFIEDPROBLEM="发生了一个未定义的错误.";
	DICTUNKNOWNREASON1="有一些事（问题）发生.";
	DICTUNKNOWNREASON2="很不幸, 通知脚本被意外的调用";
	DICTUNKNOWNREASON3="这是一条调试信息:";
	DICTUNKNOWNREASON4="不该发生的错误,请通知管理员.";
	DICTRECEIVEDON="收到（于）";
	DICTPOLLFAILED="轮询检索\(传真\)失败";
	DICTYES="是";
	DICTNO="否";
	DICTRECEIVED="收到";
	DICTTIMETORECV="接收的时间";
	DICTERRCORRECT="错误修正";
	DICTCALLID1="调用\(者\)ID1";
	DICTCALLID2="调用\(者\)ID2";
	DICTCALLID3="调用\(者\)ID3";
	DICTCALLID4="调用\(者\)ID4";
	DICTCALLID5="调用\(者\)ID5";
	DICTCALLID6="调用\(者\)ID6";
	DICTCALLID7="调用\(者\)ID7";
