#    $Id: dict-fr.in 1126 2012-12-04 04:52:46Z faxguy $

	CHARSET=UTF-8;
	DICTRECEIVEAGENT="The HylaFAX Receive Agent";
	DICTRECEIVEDFROM="Fax reçu de \$SENDER";
	DICTRETRIEVEDFROM="Fax recherché de \$SENDER";
	DICTMSGINTRO="La totalité du document n'a pas été reçu pour la raison :";
	DICTLOGFOLLOWS="    ---- La transcription de la session ----";
	DICTLOGFOLLOWS2="La transcription de la session";
	DICTNOLOGAVAIL="    Pas de transcription disponible";
	DICTDISPATCHEDTO="Le fax a été automatiquement expédié à : \$SENDTO.";
	DICTPOLLDISPATCHTO="Le fax a été voté près et livré à : \$MAILADDR.";
	DICTNOTRECEIVED="fax non reçu";
	DICTATTEMPTEDFAXFAILED="An attempt to receive facsimile on \$DEVICE failed because:"
	DICTATTEMPTEDPOLLFAILED="An attempt to retrieve facsimile on \$DEVICE failed because:";
	DICTFAILEDBECAUSE="à échoué pour la raison suivante : ";
	DICTUNKNOWNDOCTYPE="Type de document inconnue";
	DICTNOFILEEXISTS="Fichier inexistant";
	DICTDESTINATION="Destination";
	DICTJOBID="Identifiant du travail";
	DICTGROUPID="Identifiant du groupe";
	DICTSENDER="Emetteur";
	DICTMAILADDR="Adresse mail";
	DICTMODEM="Modem";
	DICTCOMMID="CommID";
	DICTSUBMITTEDFROM="Envoyé par";
	DICTPAGEWIDTH="Largeur de page";
	DICTPAGELENGTH="Hauteur de page";
	DICTRES="Résolution ";
	DICTNOTHINGAVAIL="rien de disponible";
	DICTSTATUS="Status ";
	DICTREMOTEEXCHANGES="échanges avec l'équipement distant";
	DICTDIALOGS="Dialogues ";
	DICTFAILEDCALLS="appels consécutifs échoués au destinataire";
	DICTDIALS="Appels échoués ";
	DICTTOTALCALLS="nombre totals d'appel avant émission";
	DICTCALLS="Totals appels ";
	DICTPAGESTRANSMITTED="pages transmisent";
	DICTPAGES="Pages";
	DICTTOTALPAGES="nombre total de pages transmisent";
	DICTTOTPAGES="Nombre total de pages ";
	DICTATTEMPTSPAGE="tentative d'envoie de la page en cours";
	DICTATTEMPTS="Tentatives ";
	DICTDIRNEXTPAGE="annuaire de la prochaine page à envoyer";
	DICTDIRNUM="Numéro annuaire ";
	DICTDOCSSUBMITTED="Documents soumis à la transmission";
	DICTDOCSTEXT1="Les documents suivants ont été soumis pour la transmission et sont ";
	DICTDOCSTEXT2="disponible sur le serveur pour la réutilisation jusqu\'à ce qu\'ils soient automatiquement ";
	DICTDOCSTEXT3="purgé lorsque ce travail sera `if [ \"\$doneop\" = archive ]; then echo 'archié'; else echo 'supprimé'; fi`. Les documents peuvent également être manuellement ";
	DICTDOCSTEXT4="enlevé en utilisant la commande faxrm\; consultez faxrm\(1\) pour plus informations.";
	DICTFILENAME="Nom du fichier";
	DICTSIZE="Taille";
	DICTTYPE="Type";
	DICTUNSENTPAGES="Unsent pages submitted for transmission";
        DICTUNSENTJOBSTATUS="Statut du travail d'Unsent";
	DICTPIN="PIN ";
	DICTMESSAGETEXT="Message";
	DICTNOREASON="aucune raison n'a été enregistré";
	DICTYOURJOBTO="Votre \$THISJOBTYPE envoyé au numéro : \$number";
	DICTfacsimile="fax";
	DICTpager="pager";
	DICTJOB="Votre \$THISJOBTYPE numéro \$jobid envoyé";
	DICTAT="à";
	DICTTO="au";
	DICTCOMPLETED="a réussi";
	DICTCOMPLETEDSUCCESSFULLY=", a été effectué avec succès.";
	DICTRECEIVER="Récepteur";
	DICTQUALITY="Qualité";
	DICTFINE="Fin";
	DICTNORMAL="Normal";
	DICTSIGNALRATE="Vitesse de transmission";
	DICTDATAFORMAT="Format données";
	DICTREMOTEEQUIPMENT="Equipement distant";
	DICTREMOTESTATION="Station distante";
	DICTPROCESSINGTIME="Le temps d'émission est de :";
	DICTADDITIONALINFO="  Informations complémentaire :";
	DICTFAILED="échoué";
	DICTREJECTEDBECAUSE="a été rejeté pour la raison : ";
	DICTBLOCKED="bloqué";
	DICTDELAYEDBECAUSE="est retardé dans la file d'attente pour la raison :";
	DICTASSOONASPOSSIBLE="Le travail sera traité dès que possible.";
	DICTREQUEUED="a été remis en file d'attente";
	DICTWASNOTSENT="n'a pas été envoyé pour la raison : ";
	DICTWILLBERETRIED="Le travail sera relancé à";
	DICTREMOVEDFROMQUEUE="a été supprimé de la file d'attente";
	DICTWASDELETED="a été supprimé de la file d'attente.";
	DICTTIMEDOUT="n'a pas pu être accompli avant la date-limite désignée.";
	DICTCONVERSION1="n'a pas été envoyé parce que la conversion du document";
	DICTCONVERSION2="fax a échoué. La sortie du programme de convertion est :";
	DICTCONVERSION3="Contrôler les fichiers PostScript et vérifié les polices non-standard ou une structure invalide";
	DICTNOFORMATTER1="n'a pas été envoyé parce que";
	DICTNOFORMATTER2="le script de conversion n'a pas été trouvé.";
	DICTNOTICEABOUT="Notice about";
	DICTPOLLINGFAILED=", une demande de 'polling',\nn'a pas pu être accomplie parce que ";
	DICTREMOTEREJECTED="L'équipement distant a rejeté votre demande.";
	DICTNODOCTOPOLL="aucun document n'est disponible pour la récupération.";
	DICTUNSPECIFIEDPROBLEM="un problème non spécifié s'est produit.";
	DICTUNKNOWNREASON1="had something happen to it.";
	DICTUNKNOWNREASON2="Unfortunately, the notification script was invoked with an unknown reason";
	DICTUNKNOWNREASON3="so the rest of this message is for debugging:";
	DICTUNKNOWNREASON4="This should not happen, please report it to your administrator.";
	DICTRECEIVEDON="Reçu le";
	DICTPOLLFAILED="facsimile poll retrieval failed";
	DICTYES="Oui";
	DICTNO="Non";
	DICTRECEIVED="Reçu";
	DICTTIMETORECV="Heure de réception";
	DICTERRCORRECT="Error Correct";
	DICTCALLID1="CallID1";
	DICTCALLID2="CallID2";
	DICTCALLID3="CallID3";
	DICTCALLID4="CallID4";
	DICTCALLID5="CallID5";
	DICTCALLID6="CallID6";
	DICTCALLID7="CallID7";
